###################################################################################################################################
#                                                                                                                                 #
#                                                                                                                                 #
#                                                                                           S                                     #
#                                                                                                       S                         #
#                                                                                                                                 #
#                                                                                                                                 #
#                     A                          S                                                                                #
#                                                                                                                                 #
#                                                                                                                                 #
#                                                                                                                                 #
#                                                                                                       S                         #
#                                                S                                          S                                     #
#                                                                                                                                 #
#                                                                                                                                 #
#                                                                                                                                 #
#                                                                                                                                 #
#                                    S                                                                                            #
#                                                                                                                                 #
#                                                                                                                                 #
#                  S                                                                     S                                        #
#                                                                                                                                 #
#                                                                                                                                 #
#                                                                                                                                 #
#                                                           A                                                                     #
#                                                                                                                                 #
#                  S                  A                                                                                           #
#                                                                                                                                 #
#                                                                                                                                 #
#                                                           S                           S                                         #
#                                                                                                                                 #
#                                                                                                                                 #
#                                                                                                                                 #
#                     S                                                                                                           #
#                                                                                                                                 #
#                                                                                                                                 #
#                                                                                                                                 #
#                                            S                                                                                    #
#                                                                    S                      A                                     #
#                                                                                                                                 #
###################################################################################################################################
