%%%%%
%   %
% S %
%   %
%%%%%
