#######
#A A A#
#     #
#S   S#
#######
