%%%%%
% S %
% % %
% A %
%%%%%
