##########
#        #
#    M   #
#    S   #
##########
